umsonst- free,in vain
komisch - comic. strage
trost - consolation, comfort
verdrehen- twist, roll, pervert
vorgestern - the day before yesterday
verabreden - appoint, arrange
Reifen - Tire,
Aufpumpen - Inflate( bitten Aufpumpen den Reien)
deswegen - Therefore, Because of that
doof-stupid
verfolgen-follow
eben - already, exactly
Schüchtern- Shy, Timid
übrigens -by the way
anfreunden - befriend
jedenfalls-at least, In any case, any way
doch- but, nevertheless, Though, After all, Really, Anyway, but, yet
freuen - please, gefallen, zufrieden
krieg -war, warfare
kriegen - get, have , catch
echt- real, genuine, really genuinely
hilfsbereit - helpful
stimmen - vote, to be right
Schubs - push , poke
bloß - just, simply, purely
gerade - just, right, now
verabschieden - adopt, pass, discharge
behandeln- treat
vorteil- advantage
nachteil-Disadvantage
Schlapp - limp
sowieso- anyway
Drachen - Dragon, Kite
Oben - Above
Unten - Under
Sogar - Even
Anstregend - Exhausting
Auseinandergehen - Break-Up, seperate, Diverge, differ
Perser - Persian
böse  - bad, evil 
Selbstauslöser- self-timer
beeilen
winkel - angle
Sozusagen - so to speak
Berühmt - Famous
verlieren- lose
verpassen - lose
unbedingt -really, unconditional
Märchen -Fairy Tale, Tale , Story
Märche - Wonderland
Also - So , That is, well, now
Peinlich - Embarrassing
Teufel - Devil, Demon, Fiend
versprechen - Promise
Schmeißen - Werfen
verzaubern- enchant
verzaberten -
einzige - single
verstecken - Hide
einwanderung - immigration
auswandering - emigration
behörde - Authority, Office
falls -if, any case 
hereausgehen - go out
vertrauen - Trust, believe, glauben
fassen - take, touch
Schleppen - Drag, Haul
Stimmung - Mode, Atmosphere
entspannen - relax
klappen - fold, work out
Eifer - Zeal, Enthusiasm
SÜchtig - Addicted
EiferSüchtig - Jealous
Kümmern - Concern , Care 
Wegen - Because of
Pädagogisch - Pedagogic(Concerning Teaching Method)
Gespenst - Ghost, Specter
herum - About, around
Riesig - Huge, Enormous
Teppiche - Carpets
Weiher - Pond
Ausschütten - Distribute
Schütten - pour, Spill
Empfinden - Fühlen, Spüren
Anfassen - Touch, Handle
Schwul - Gay, 
Wahnsinnig - Mad, Insane
verhalten - behave
verhaltun-
Nackten - Naked 
eher - more, likely
pauken - cram, push 
Quatschen - chatter, klappern
Abbrechen - Break off, Quit
Dulden - Tolerate, suffer
leiden- suffer, tolerate
Erleichtern - Facilitate, Ease, Relieve
erleichterung - Facility
Ertragen - Bear
Schleppen- Drag 
Stück - Piece 
Zweifel - Doubt
Zweifeln - to Doubt
Verhindern - Prevent
Ausfallen - drop out, be cancelled
Haltung - Attitude
Zurückhaltung - restrain, caution
entdecken - Discover
Fordern - Demand, Require
Schach - Chess
Herausfordern - to Challenge
Herausforderung -
empfehlen - 
versammlung - Meeting, assembly
Angabe- information, instruction
Abstimmung - Vote
Zustimmung - Permission,  Consent
mehrheit - majority
Swar
verwirklichen - Realize, achieve(Ziel, Traum)
Abwechslung - change(vom alltag)
Beschwerde - Complaint
Beschweren -(reflexive verb) comlain -- Ich moechte mich beschweren
Ernähren - feed, nourish
Ernährung - food, nutrition
bevorzugen - (lieber moegen) prefer, give preference to
aufregend - Exciting
Mitbewohner - 
Einschreiben - register/ signup
Praxis - Practice
Anteil - Part
Andauern - Persist , GO on
Daumendrücken - cross one's fingers
Aufregen- Excite
aufgeregt - excited 
Bescheid - Notification
Kommilitonen - Fellow Student
entweder - Either
Annehmen - Accept
Bescheurt - Verrückt, dumm
unfassbar -unbelievable, unfathomable
Zusätzlich - Additional - Extra
Rathaus - Town hall
